Chiniot: [Faisalabad, Sargodha, Multan],
Faisalabad: [Chiniot, Sheikhupura, Sargodha],
Sheikhupura: [Faisalabad, Lahore, Gujranwala, Okara],
Gujranwala: [Lahore, Sheikhupura, Gujrat, Sialkot],
Sialkot: [Gujranwala, Gujrat, Rawalpindi],
Gujrat: [Gujranwala, Jhelum, Sialkot],
Jhelum: [Gujrat, Rawalpindi, Islamabad],
Rawalpindi: [Jhelum, Islamabad, Chakwal, Sialkot],
Islamabad: [Rawalpindi, Peshawar, Abbottabad],
Lahore: [Sheikhupura, Gujranwala, Kasur],
Sargodha: [Chiniot, Faisalabad, Chakwal, Layyah],
Chakwal: [Sargodha, Rawalpindi, Bhakkar],
Multan: [Chiniot, Bahawalpur, Muzaffargarh],
Okara: [Sheikhupura, Sahiwal],
Kasur: [Lahore, Ferozewala],
Layyah: [Sargodha, Muzaffargarh],
Bhakkar: [Chakwal, Mianwali],
Bahawalpur: [Multan, Rahim Yar Khan],
Muzaffargarh: [Multan, Layyah],
Sahiwal: [Okara, Pakpattan],
Ferozewala: [Kasur, Nankana Sahib],
Mianwali: [Bhakkar, Attock],
Rahim Yar Khan: [Bahawalpur, Dera Ghazi Khan],
Pakpattan: [Sahiwal, Okara],
Nankana Sahib: [Ferozewala, Sheikhupura],
Attock: [Mianwali, Rawalpindi],
Dera Ghazi Khan: [Rahim Yar Khan, Multan, Rajanpur],
Abbottabad: [Islamabad, Mansehra],
Peshawar: [Islamabad, Nowshera],
Nowshera: [Peshawar, Mardan],
Mardan: [Nowshera, Swabi],
Mansehra: [Abbottabad, Batagram],
Batagram: [Mansehra, Shinkiari],
Shinkiari: [Batagram, Mansehra],
Rajanpur: [Dera Ghazi Khan]